50
50
11111111111111111111111111111111111111111111111111
11111111111111111111111111111111111111111111111111
11000000000000000000000000000000000000000000001111
11000000000000000000000000000000000000000000001111
11000000000000000000000000000000000000000000001111
11000000000000000000000000000000000000000000001111
11000000000000000000000000000000000000000000001111
11000000000000000000000000000000000000000000001111
11000000000000000000000000000000000000000000001111
11000000000000000000000000000000000000000000001111
11000000000000000000000000000000000000000000001111
11000000000000000000000000000000000000000000001111
11000000000000000000000000000000000000000000001111
11000000000000000000000000000000000000000000001111
11000000000000000000000000000000000000000000001111
11000000000000000000000000000000000000000000001111
11000000000000000000000000000000000000000000001111
11000000000000000000000000000000000000000000001111
11000000000000000000000000000000000000000000001111
11000000000000000000000000000000000000000000001111
11000000000000000000000000000000000000000000001111
11000000000000000000000000000000000000000000001111
11000000000000000000000000000000000000000000001111
11000000000000000000000000000000000000000000001111
11000000000000000000000000000000000000000000001111
11000000000000000000000000000000000000000000001111
11000000000000000000000000000000000000000000001111
11000000000000000000000000000000000000000000001111
11000000000000000000000000000000000000000000001111
11000000000000000000000000000000000000000000001111
11000000000000000000000000000000000000000000001111
11000000000000000000000000000000000000000000001111
11000000000000000000000000000000000000000000001111
11000000000000000000000000000000000000000000001111
11000000000000000000000000000000000000000000001111
11000000000000000000000000000000000000000000001111
11000000000000000000000000000000000000000000001111
11000000000000000000000000000000000000000000001111
11000000000000000000000000000000000000000000001111
11000000000000000000000000000000000000000000001111
11000000000000000000000000000000000000000000001111
11000000000000000000000000000000000000000000001111
11000000000000000000000000000000000000000000001111
11000000000000000000000000000000000000000000001111
11000000000000000000000000000000000000000000001111
11000000000000000000000000000000000000000000001111
11000000000000000000000000000000000000000000001111
11000000000000000000000000000000000000000000001111
11111111111111111111111111111111111111111111111111
11111111111111111111111111111111111111111111111111