5
10
1111111111
1230000021
1000000001
1000000001
1111111111