1111111111111111111111111111111111111111
1030430303303H40330033430334303303344331
133P333333303343343333032433334330330331
D003333300333434303343423333343333303331
1333334303333343333303330440333034330331
1111111111113344333303003333033333303331
130E330334300333003333033303333111111111
1333033303330333003343333333433334333231
13343334304344333333343433000333033E0301
1333334333334323000433030333343333303331
122203333330332333033403E330343333333301
133303430030343E333333300330043300342331
133333433030300033333433333333330E333431
1333433333333333330033333333334333244031
1300030043443341111111111111333344303031
1443333000333433433334333333333333333001
10E3333330003333334333343334330334403321
1003034222333333400E334332333300434E4021
1333333333334000003000303340043330004031
1334330330033300343333003003343433330331
1333300333333333343333333333003330433331
1111111111111111111111111111111111111111