80
44
11111111111111111111111111111111111111111111
11111111111111111111111111111111111111111111
10001003000000000000000000000000000000000001
10001333000000000000000000000000000000000001
10001343000000000000000000000000000000000001
10001333020000000000000000000000000000000001
10001333020000000000000000000000000000000001
10001333000000000000000000000000000000000001
10001333000000000000000000000000000000000001
10001333000000000000000000000000000000000001
10001333000000000000000000000000000000000001
10001333000000000000000000000000000000000001
10003331000000000000000000000000000000000001
10003331000000000000000000000000000000000001
10003331000000000000000000000000000000000001
10003331000000000000000000000000000000000001
10003331000000000000000000000000000000000001
10003331000000000000000000000000000000000001
10003341000000000000000000000000000000000001
10003341000000000000000000000000000000000001
10003431000000000000000000000000000000000001
10003333000000000000000000000000000000000001
10003333000000000000000000000000000000000001
10004333000000000000000000000000000000000001
10003333000000000000000000000000000000000001
10003443000000000000000000000000000000000001
10003433000000000000000000000000000000000001
10003333000000000000000000000000000000000001
10003333000000000000000000000000000000000001
10003333000000000000000000000000000000000001
10000000000000000000000000000000000000000001
10000000000000000000000000000000000000000001
10000000000000000000000000000000000000000001
10000000000000000000000000000000000000000001
10000000000000000000000000000000000000000001
10000000000000000000000000000000000000000001
10000000000000000000000000000000000000000001
10000000000000000000000000000000000000000001
10000000000000000000000000000000000000000001
10000000000000000000000000000000000000000001
10000000000000000000000000000000000000000001
10000000000000000000000000000000000000000001
10000000000000000000000000000000000000000001
10000000000000000000000000000000000000000001
10000000000000000000000000000000000000000001
10000000000000000000000000000000000000000001
10000000000000000000000000000000000000000001
10000000000000000000000000000000000000000001
10000000000000000000000000000000000000000001
10000000000000000000000000000000000000000001
10000000000000000000000000000000000000000001
10000000000000000000000000000000000000000001
10000000000000000000000000000000000000000001
10000000000000000000000000000000000000000001
10000000000000000000000000000000000000000001
10000000000000000000000000000000000000000001
10000000000000000000000000000000000000000001
10000000000000000000000000000000000000000001
10000000000000000000000000000000000000000001
10000000000000000000000000000000000000000001
10000000000000000000000000000000000000000001
10000000000000000000000000000000000000000001
10000000000000000000000000000000000000000001
10000000000000000000000000000000000000000001
10000000000000000000000000000000000000000001
10000000000000000000000000000000000000000001
10000000000000000000000000000000000000000001
10000000000000000000000000000000000000000001
10000000000000000000000000000000000000000001
10000000000000000000000000000000000000000001
10000000000000000000000000000000000000000001
10000000000000000000000000000000000000000001
10000000000000000000000000000000000000000001
10000000000000000000000000000000000000000001
10000000000000000000000000000000000000000001
10000000000000000000000000000000000000000001
10000000000000000000000000000000000000000001
10000000000000000000000000000000000000000001
11111111111111111111111111111111111111111111
11111111111111111111111111111111111111111111