80
44
33333333333333333333333333333333333333333333
33333333333333333333333333333333333333333333
30000000000000000000000000000000000000000003
30000000000000000000000000000000000000000003
30000110000000000000000000000000000000000003
30000000000000000000000000000000000000000003
30000000000000000000000000000000000000000003
30000000000000000000000000000000000000000003
30000000000000000000000000000000000000000003
30000000000000000000000000000000000000000003
30000000000000000000000000000000000000000003
30000000000000000000000000000000000000000003
30000000000000000000000000000000000000000003
30000000000000000000000000000000000000000003
30000000000000000000000000000000000000000003
30000000000000000000000000000000000000000003
30000000000000000000000000000000000000000003
30000000000000000000000000000000000000000003
30000000000000000000000000000000000000000003
30000000000000000000000000000000000000000003
30000000000000000000000000000000000000000003
30000000000000000000000000000000000000000003
30000000000000000000000000000000000000000003
30000000000000000000000000000000000000000003
30000000000000000000000000000000000000000003
30000000000000000000000000000000000000000003
30000000000000000000000000000000000000000003
30000000000000000000000000000000000000000003
30000000000000000000000000000000000000000003
30000000000000000000000000000000000000000003
30000000000000000000000000000000000000000003
30000000000000000000000000000000000000000003
30000000000000000000000000000000000000000003
30000000000000000000000000000000000000000003
30000000000000000000000000000000000000000003
30000000000000000000000000000000000000000003
30000000000000000000000000000000000000000003
30000000000000000000000000000000000000000003
30000000000000000000000000000000000000000003
30000000000000000000000000000000000000000003
30000000000000000000000000000000000000000003
30000000000000000000000000000000000000000003
30000000000000000000000000000000000000000003
30000000000000000000000000000000000000000003
30000000000000000000000000000000000000000003
30000000000000000000000000000000000000000003
30000000000000000000000000000000000000000003
30000000000000000000000000000000000000000003
30000000000000000000000000000000000000000003
30000000000000000000000000000000000000000003
30000000000000000000000000000000000000000003
30000000000000000000000000000000000000000003
30000000000000000000000000000000000000000003
30000000000000000000000000000000000000000003
30000000000000000000000000000000000000000003
30000000000000000000000000000000000000000003
30000000000000000000000000000000000000000003
30000000000000000000000000000000000000000003
30000000000000000000000000000000000000000003
30000000000000000000000000000000000000000003
30000000000000000000000000000000000000000003
30000000000000000000000000000000000000000003
30000000000000000000000000000000000000000003
30000000000000000000000000000000000000000003
30000000000000000000000000000000000000000003
30000000000000000000000000000000000000000003
30000000000000000000000000000000000000000003
30000000000000000000000000000000000000000003
30000000000000000000000000000000000000000003
30000000000000000000000000000000000000000003
30000000000000000000000000000000000000000003
30000000000000000000000000000000000000000003
30000000000000000000000000000000000000000003
30000000000000000000000000000000000000000003
30000000000000000000000000000000000000000003
30000000000000000000000000000000000000000003
30000000000000000000000000000000000000000003
30000000000000000000000000000000000000000003
33333333333333333333333333333333333333333333
33333333333333333333333333333333333333333333