1111111111111111111111111111111111111111
1030430303303H40330033430334303303344331
133P333333303343343333032433334330330331
D003333300333434303343423333343333303331
1333334303333343333303330440333034330331
1111111111113344333303003333033333303331
1300330334300333003333033303333111111111
1333033303330333003343333333433334333231
1334333430434433333334343300033303300301
1333334333334323000433030333343333303331
1222033333303323330334030330343333333301
1333034300303430333333300330043300342331
1333334330303000333334333333333300333431
1333433333333333330033333333334333244031
1300030043443341111111111111333344303031
1443333000333433433334333333333333333001
1003333330003333334333343334330334403321
1003034222333333400033433233330043404021
1333333333334000003000303340043330004031
1334330330033300343333003003343433330331
1333300333333333343333333333003330433331
1111111111111111111111111111111111111111