1111111111111111111111111111111111111111
1333333033234H33333434333333303333433331
134P4330E330333333333423343333033333E331
1333333333303343333343433433333333433331
1434433333333343333334334333343334333331
1430433333333304334333333334333333434431
1333033433333333433333430433333333434431
1111111111111111111111111111111333433431
1303334332303343433333333332342333333031
1332333334333330333333334304334333343331
1333433434333333333333334034334333333331
1343333343333333344433333334330323333431
1323303343003333343423323333433343323031
1304333333333333334043343333333323333341
1333333331111111111111111111111111111111
1043333333334333233334333334333433333331
10433333333304334333333334333333434433D1
13033433333333433333430E3333233343443331
1333342334333333334333333434233333343331
1333033430334344333333333434233333303341
1323333033333033333333303433433334333431
1111111111111111111111111111111111111111