11111111111111111111111111111111111111111111
13333300031333333333333334443333133333330331
13004333031033333330004433330033133333333031
1330033333133000333330E30E033333133003332331
13200432331330333233330033003343133304433301
13300432301032331111111111111111133333433301
1302233330103333333333333333333233E333303331
130023440310300003300333P0033332300322300331
1333034303102333333300033033033440333330E301
100033330310322333330E3333330043330032333301
10333003431333300033333000333344333333333301
10330333331111111111111111113334433130343331
130440000333433334343330033133303031300443E1
130343330333334444343333303133303331030E4301
133343303H0033000E33303330010333033133304031
13033300333003333030000303013444033133234031
130E3333330333333003333300313333333103223301
13333111111111111111111111113300E03103330301
13034433333333333322333343443032303133303331
13033430000344334432300300E43432003103430231
13333033333443033333333333300033333133330031
1111111111111111111111D111111111111111111111
