1111111111111111111111111111111111111111
1333330003133H33333333333444333313330331
130P433303103333333000443333003313333031
1330033333133000333330E30E03333313302331
1320043233333033323333003300334313333301
1330043230103233111111111111111113333301
1302233330103333333333333333333233E33331
1300234403103000033003330003333230030331
133303430310233333330003303303344033E301
100033330310322333330E333333004333003301
1033300343133330003333300033334433333301
1033033333111111111111111111333443313331
13044000033343333434333003313330303143E1
1303433303333344443433333031333033314301
13334330300033000E3330333003033303314031
1303330033300333303000030301344403314031
130E333333033333300333330031333333313301
13333111111131111111311111113300E0310301
1303443333333333332233334344303230313331
13033430000344334432300300E4343200310231
1333303333344303333333333330003333310031
1111111111111111111111D11111111111111111