1111111111111111111111111111111111111111
1333330003133H33333333333444333313330331
130P433303103333333000443333003313333031
1330033333133000333330030003333313302331
1320043233333033323333003300334313333301
1330043230103233111111111111111113333301
1302233330103333333333333333333233033331
1300234403103000033003330003333230030331
1333034303102333333300033033033440330301
1000333303103223333300333333004333003301
1033300343133330003333300033334433333301
1033033333111111111111111111333443313331
1304400003334333343433300331333030314301
1303433303333344443433333031333033314301
1333433030003300003330333003033303314031
1303330033300333303000030301344403314031
1300333333033333300333330031333333313301
1333311111113111111131111111330000310301
1303443333333333332233334344303230313331
1303343000034433443230030004343200310231
1333303333344303333333333330003333310031
1111111111111111111111D11111111111111111